cl_name	motifs
AGGU	GGUCG, GGUCC, AGGGU, GGUCA, GGGUA, CGGGU, AGGUC, GGGUC, AGGUU, UAGGA, AGGUA, CAGGU, UAGGU, UAGGG, AGGUG, UAGGC, AUAGG, AAGGU, GUAGG, CUAGG, GGUAU, UUAGG, GAGGU
KGUG	GGUUA, UUGGU, UGGUU, CUGGU, UGGUC, GGUUU, AUGGU, UUUGG, GGUUC, GUUGG, GGUUG, UGGUA, GGGUU, AGUGA, GAGUG, GGUGA, UGAGU, UGAGG, UUGAG, GUGAA, CGUGA, GUGAG, UGUGG, UUGUG, UGUGA, UGUGC, AUGUG, UGUGU, GGUGU, GUGUU, GUGUG, GUGUA, CGUGU, AGUGU, CUGUG
GGCU	UGGCC, UGGCG, UGGCU, AGGCU, CUGGC, UGGCA, AUGGC, GGCUU, GGCUC, GGCUA, UCUGG, GGCUG, UUGGC, GGGCU, ACUGC, CUGCA, CUGCG, UGCUG, CUGCU, AGCUG, UCUGC, GCUGU, GCUGG, GCUGC, CGCUG
CAGG	CCAGG, GGCAG, AGGCA, CAGGG, CAGGC, GCAGG, CAGGA, UGCAG, UCAGG
UGGG	GUGGU, GUGGA, GUGGG, GGUGG, GUGGC, GGGUG, AGUGG, CGGUG, UGGUG, CGUGG, UGGGU, GGGGU, CUGGG, UGGGC, UGGGA, UUGGG, UGGGG, AGGGG, AUGGG, GGGGG, GGGGA
GAGG	GAGGA, AGGAG, GGAGU, GGAGG, CGAGG, AGGGA, GAGGC, GAGGG, GGGAG
GGGC	CGGCU, GGCCU, CGGCC, CGGCA, GGCCC, AGGCC, ACGGC, GCCGG, CCCGG, GGCCG, CCGGC, GGCCA, CGCGG, GCGGC, CGGCG, GGCGC, UCGGC, GGCGG, AGGCG, GGCGU, GGGCC, ACGGG, GGGCG, CCGGG, CGGGC, CGGGG, UCGGG, GGGGC, GCGGG, GGGCA, CGGGA, AGGGC
CCGC	ACGCC, CCCGC, CGCCA, UCCGC, CCGCC, CCGCU, CGCCU, CGCCG, CGCCC, GCCGC, GCCCG, AGCGC, GCGCG, ACGCG, CGCGC, UCGCG, CGCGU, CCGCG, GCGCU, GCGCC
UGCG	CGGUA, UCGGA, CUCGG, UCGGU, CGGUU, ACGGU, UUCGG, CGGUC, GCGGU, GUCGG, CCGGU, CGUGC, GUGCA, AUGCG, GUGCG, GCGUG, GGUGC, GUGCU, UGCGG, UGCGU, AGUGC, UGCGC, UUGCG
UCGU	GCUCG, UUCGC, CCUCG, UCGCA, CGCUC, UCGCC, CUCGC, ACUCG, UCGCU, UCUCG, CUCGA, CGUUA, CGUUG, CUCGU, UUCGU, GCGUU, CGUUC, UCGUU, GUUCG, CGUUU, UCGUG, CCCGU, UCCGU, GCCGU, CCGUG, UCCGG, CCGUU, CUCCG, UUCCG, CGUCC, AUCCG, GUCCG, CCGUC, GCGUC, GUCGA, GUCGC, GUCGU, AGUCG, UGUCG, CGUCA, CGUCU, UCGUC, CGUCG
ACCG	UCGAU, UAUCG, UCGAC, CAUCG, UUCGA, UCGAG, AAUCG, AUCGU, AUCGG, AUCGC, AUCGA, UCGAA, GAUCG, CCGAC, GACCG, ACCGU, CCGAG, GCCGA, AGACC, CACCG, UCCGA, AACCG, CCGAA, CCGAU, ACCGG, CGACC, CCCGA, CGACA, ACCGA, ACCGC, AGACG, ACGAC, UGACG, ACGAG, GACGA, GACGG, GACGC, UACGA, CGACG, CACGA, ACGAU, ACGAA, GAACU, AACGC, AACGG, GAACG, GAACC, GGAAC, CGAAC, UGAAC, AGAAC, AACGA, GCGAA, GGCGA, CGAUG, CGCGA, UGCGA, CGAUC, CGAGU, CGAUU, GCGAC, GCGAU
CGGA	CGGAC, CGGAU, GCGGA, CACGG, AGGAC, CGGAG, GGGAC, GGACA, ACGGA, CCGGA, GGACG, GGACC, CGGAA, AGCGU, GCGAG, AGCGG, AGCGA, GGAGC, UAGCG, CGAGC, AGAGC, AAGCG, GAGCG, UGAGC
CACG	ACGUG, CGUAU, CACGU, CCGUA, CGUAG, CGUAA, GCGUA, UCGUA, AACGU, GACGU, ACGUA, UACGU, ACGUU, ACGUC, CGCAG, CGCAA, CGCAC, GCGCA, CGCAU, GCACG, CACGC, GCACU, UGCAC, CCGCA, ACGCA, GGCAC, GCACC, GCUAU, UGCUA, GCUAC, CGCUU, GCUAA, CGCUA, ACGCU, ACACG, ACACC, GACAC, ACACA, ACACU, CACAC, GCACA, UCACA, UACAC, CCACA, UACGC, GUACA, GUACU, CGUAC, GGUAC, GUACC, AGUAC, UGUAC, GUACG, UACGG, AUACG
ACCA	AUACU, UACUA, GACUA, ACUAC, UACUC, CACUA, ACUAU, UACUG, CUACU, AUAAC, UUAAC, CUAAC, ACUAA, UCUAA, CAACU, AACUC, AACUA, UAACA, GUAAC, UAACC, UAACG, UAACU, AACUU, UAUCU, UUAUC, GAUCU, CAUCU, GUAUC, AUCUG, AUCUU, AUCUC, AAUCU, CUAUC, UCUAU, AUCUA, CUUAG, CUUAA, CCUUA, UUACU, UUACG, UUACA, UCUUA, ACUUA, GUUAC, UUACC, CUUAC, AUUAC, GCUUA, AACAA, GAAAC, CAAAC, GAACA, AAACU, AAACG, ACAAA, AAACA, AAAAC, AAACC, GACCA, CCAAG, CCAAC, CCAAA, AACCA, UACCA, CCAAU, ACCAU, ACCAA, ACCAG, CCUAC, UCUAC, CUACG, UACCC, UACCG, CUACC, CUACA, AUACC, CAUUG, CCAUU, CAUUC, CAUUA, GAUUC, AUUCG, UCAUU, AUUCA, AUUCC, CUCAU, GAUCA, UCAUA, GUCAU, UCAUC, AUCAG, UAUCA, CAUCA, AUCAU, CCUAU, CCUAG, CCUAA, GCCUA, UCCUA, UACCU, AACCU, ACCUA, GACCU, ACCUU, ACCUC, UCAAA, CAAUC, UCAAU, UCAAG, AAUCA, GUCAA, UUCAA, AUCAA, AUCAC, GCAUA, UACAU, CACAU, AUACA, CAUAU, CAUAG, CAUAC, CAUAA, ACAUA, ACAUC, CCAUA, ACAUU, GACAU, AACAU, ACAAG, ACAAU, UCAAC, ACAAC, CACAA, GACAA, CAACG, AACAC, CAACC, CAACA, UACAA
WAUA	GUAGA, GUAGC, GGUAG, CAGUA, GUAGU, UAGUA, GAGUA, UGUAG, AGUAU, AGUAG, AGUAA, GCAAC, GCAAU, GCAAG, AAGCA, UGCAA, GCAAA, AGCAA, GGCAA, CAAGC, UAAAA, UAAAU, AUAAA, UAAAC, UUAAA, AAAAA, AAAAU, CUAAA, GAAAA, CAAAA, UGAAG, UGAAU, UUGAA, GAAUA, CUGAA, AUGAA, GAAUU, GAAUG, GAAUC, CGAAU, GGAAU, AGAAU, CAAGU, AAGUA, AAGUG, UAAGU, GUUAA, UUAAG, AAGUU, AUAAG, UAAGC, GUAAG, CUAAG, AAUAA, AAUAC, CUAAU, AAUAG, AUAAU, AAUAU, UAAUC, AAAUA, UAAUA, CAAUA, UAUAA, AGCUU, AUAGC, GCUAG, AGCUC, GAGCU, AGCUA, CAGCU, UAGCU, UUAGC, AAGCU, CUAGC, UAGCA, AGUUU, UAGUU, GUUAG, UUAGU, AGUUA, AGUUC, CAGUU, GAGUU, AUAGU, UAGUC, UAGUG, AGUUG, CUAUA, UAUAU, UAUAG, AUAUU, UAUAC, UUAUA, GAUAU, GUAUA, AUAUA, AUAUC, UUAGA, UAGAA, UAGAC, UCUAG, ACUAG, UAGAG, CUAGA, CUAGU, GAGAU, UAGAU, AAGAU, AUAGA, GAUAG, CAGAU, AGAUU, GAUAC, AGAUC, AGAUA, GGAUA, CGAUA, GAUAA, GCAGU, CCAGU, GAGUC, AGUCU, CAGUG, UCAGU, AGUCA, GUCAG, AAGUC, CAGUC, AGUCC, CAUGA, CAUGC, GGCAU, UCAUG, CCAUG, UGCAU, ACAUG, CAUGG, AUGCA, GCAUC, GCAUG, GCAUU, GUGAU, GUUGA, GAUUG, UUUGA, UUGAU, UUGAC, AUUGA, UGAUC, UGAUU, CUGAU, UGAUA, ACUGA, UCUGA, CCUGA, UGACC, CUGAC, CUGAG, GCUGA, UGACA, GUGAC, AUGAC, GUAAU, UGUAA, UUGUA, CUGUA, GGUAA, GUAAA, GAAAU, CAAAU, AAUGA, AAUGG, AAUGU, UAAUG, AAUGC, AAAUG, AAAUC, CAAUG, AAAGA, CAAAG, UGAAA, AGAAA, AAAAG, UAAAG, CGAAA, GAAAG, AAAGU, AAAGG, AAAGC, GGAAA, AAUUA, AAUUC, AAUUG, GAUUA, AUUAG, CAAUU, AUUAA, UUAAU, AAAUU, UAAUU, AUGUC, CAUGU, AUGUU, GUAUG, UUAUG, AUGUA, AUAUG, UAUGC, UGUAU, UAUGG, UAUGU, CUAUG, ACUGG, CGACU, ACUGU, AGACU, AACUG, GACUC, GGACU, CACUG, UGACU, GACUG
CAGC	UCAGC, ACAGC, GCAGC, AGCAC, CCAGC, AGCAG, CAGCA, AGCAU, CAGCG, GAGCA, UAGCC, GAGCC, GCCAG, UGCCA, AGCCU, AGCCG, AGCCC, GCCAU, AGCCA, CAGCC, AAGCC, GCCAA, UACAG, AACAG, CAGAA, ACAGA, ACAGG, ACAGU, CAGAC, CACAG, GACAG, AGACA, UCAGA, CCAGA, GCAGA
GAAG	GGAGA, CAGAG, CGAGA, UGAGA, AGAGG, AGAGA, GAGAG, AGAGU, GAGAC, GGAUC, AUUGG, AGGAU, GGAUG, UGGAA, UGGAC, UGGAG, UGGAU, GGAUU, UUGGA, AUGGA, GGGAU, CUGGA, GAUGG, UAUGA, UGAUG, AUGAG, AUGAU, GAUGU, GAUGA, GAUGC, AGAUG, AGGAA, GGGAA, AAGGG, UAAGG, GAAGG, GAAGU, GGAAG, CAAGG, AAGGC, AAGGA, GAGAA, AGAAG, CGAAG, CAAGA, AAGAA, UAAGA, AAGAG, GAAGC, AAGAC, GAAGA
UUUA	AUUAU, UAUUU, UUAUU, GUAUU, CUAUU, UAUUC, UAUUG, UAUUA, CUUAU, GUUAU, UUUAU, GUUCA, AUUUC, UUUCA, UUCAU, UUUCG, GUUUC, UUCAG, UUUUA, GAUUU, UUUAG, CAUUU, AAUUU, AUUUG, UUUAA, GUUUA, UUUAC, AUUUA, AUUGU, UUUGU, CUGUU, GUUGU, GUUUG, UGUUA, UGUUC, UGUUG, UGUUU, UUGUU
CUUU	UUUUC, CUUUG, UUUUG, GCUUU, UCUUU, GUUUU, CUUUA, CUUUU, UUUUU, ACUUU, AUUUU, CCUUU
CUUC	UUCCU, UUCCC, UUUCC, AUCCU, GUUCC, CUUCC, GUCCU, UCCUG, UCCUU, GUUCU, UUUCU, CUUUC, UUCUC, UUCUA, CUCUU, GCUUC, CCUUC, CUUCU, CUUCG, CUUCA, UCUUC, AUUCU, UUCUG, UUCUU
UGCC	UUGCC, UGCCU, UGCCG, GUGCC, GCCUU, CUGCC, UGCCC, GCCUG, AUGCC, UCCCU, CCUGU, CCUGG, CCUGC, GCCCU, ACCUG, CCCUU, CCCUG, CCCUA
CUUG	GACUU, CACUU, UACUU, CUUGG, CUUGA, CUUGU, UCUUG, ACUUC, ACUUG, CCUUG, AUUGC, UUGCA, UGCUC, UGCUU, UUGCU, GUUGC, GCUUG, CUUGC, AUGCU, UUUGC, CUGUC, UUGUC, GUCUA, UCUGU, GUCUC, UGUCA, GUCUG, GUCUU, UGUCU, UGUCC, GGUCU, GUGUC
CCAC	GCUCU, UCUCA, UCUCU, CUCUG, CUCUC, ACUCU, CCUCU, CUCUA, UCUCC, CCCAG, ACCCG, UCCCA, ACCCA, ACCCU, CCCAA, CCCAU, AACCC, GACCC, GCCCA, CACCA, CCACU, CCCAC, CCACG, GCCAC, CCACC, CACCC, ACCAC, CACCU, GUCCA, UCCAA, UCCAC, CAUCC, CUCCA, UCCAU, UUCCA, UCCAG, GAUCC, AUCCA, CCAUC, AAUCC, UAUCC, UUCAC, GUCAC, CACUC, CUCAG, UCACC, UCACG, UCACU, GCUCA, CUCAC, CCUCA, CUCAA, ACUCA
UCCC	UCCCC, UCCCG, AUCCC, GCCCC, CCCCG, CCCCC, GUCCC, CCCCU, CCCCA, ACCCC, ACUCC, CCCUC, GCCUC, UCCUC, GCUCC, CUCCU, CUCCC, CCUCC
